111111111
100000111
111000001
100000001
100000111
100000001
111110001
100000001
100000001
111111111